SpecialKey	SpecialKey
TermCursor	TermCursor
NonText	NonText EndOfBuffer Whitespace
Directory	Directory
ErrorMsg	ErrorMsg NvimInvalidSpacing
IncSearch	IncSearch
Search	Search QuickFixLine Substitute
MoreMsg	MoreMsg
ModeMsg	ModeMsg
LineNr	LineNr LineNrAbove LineNrBelow
CursorLineNr	CursorLineNr
Question	Question
StatusLine	StatusLine MsgSeparator
StatusLineNC	StatusLineNC
VertSplit	VertSplit FloatBorder
Title	Title
Visual	Visual
WarningMsg	WarningMsg vimWarn vimBufnrWarn
WildMenu	WildMenu
Folded	Folded vimFold
FoldColumn	FoldColumn
DiffAdd	DiffAdd
DiffChange	DiffChange
DiffDelete	DiffDelete
DiffText	DiffText
SignColumn	SignColumn
Conceal	Conceal
SpellBad	SpellBad
SpellCap	SpellCap
SpellRare	SpellRare
SpellLocal	SpellLocal
Pmenu	Pmenu NormalFloat
PmenuSel	PmenuSel
PmenuSbar	PmenuSbar
PmenuThumb	PmenuThumb
TabLine	TabLine
TabLineSel	TabLineSel
TabLineFill	TabLineFill
CursorColumn	CursorColumn
CursorLine	CursorLine
ColorColumn	ColorColumn

RedrawDebugNormal	RedrawDebugNormal
RedrawDebugClear	RedrawDebugClear
RedrawDebugComposed	RedrawDebugComposed
RedrawDebugRecompose	RedrawDebugRecompose
Cursor	Cursor
lCursor	lCursor
Normal	Normal NvimSpacing vimUserFunc vimEmbedError
FloatShadow	FloatShadow
FloatShadowThrough	FloatShadowThrough
Error	Error NvimInvalid NvimInvalidAssignment NvimInvalidPlainAssignment NvimInvalidAugmentedAssignment NvimInvalidAssignmentWithAddition
	NvimInvalidAssignmentWithSubtraction NvimInvalidAssignmentWithConcatenation NvimInvalidOperator NvimInvalidUnaryOperator NvimInvalidUnaryPlus
	NvimInvalidUnaryMinus NvimInvalidNot NvimInvalidBinaryOperator NvimInvalidComparison NvimInvalidComparisonModifier NvimInvalidBinaryPlus
	NvimInvalidBinaryMinus NvimInvalidConcat NvimInvalidConcatOrSubscript NvimInvalidOr NvimInvalidAnd NvimInvalidMultiplication NvimInvalidDivision
	NvimInvalidMod NvimInvalidTernary NvimInvalidTernaryColon NvimInvalidDelimiter NvimInvalidParenthesis NvimInvalidLambda NvimInvalidNestingParenthesis
	NvimInvalidCallingParenthesis NvimInvalidSubscript NvimInvalidSubscriptBracket NvimInvalidSubscriptColon NvimInvalidCurly NvimInvalidContainer
	NvimInvalidDict NvimInvalidList NvimInvalidValue NvimInvalidIdentifier NvimInvalidIdentifierScope NvimInvalidIdentifierScopeDelimiter
	NvimInvalidIdentifierName NvimInvalidIdentifierKey NvimInvalidColon NvimInvalidComma NvimInvalidArrow NvimInvalidRegister NvimInvalidNumber
	NvimInvalidFloat NvimInvalidNumberPrefix NvimInvalidOptionSigil NvimInvalidOptionName NvimInvalidOptionScope NvimInvalidOptionScopeDelimiter
	NvimInvalidEnvironmentSigil NvimInvalidEnvironmentName NvimInvalidString NvimInvalidStringQuote NvimInvalidSingleQuote NvimInvalidDoubleQuote
	NvimInvalidDoubleQuotedUnknownEscape NvimInvalidFigureBrace NvimDoubleQuotedUnknownEscape vimOperError vimUserAttrbError vimUserCmdError vimElseIfErr
	vimSynError vimSyncError luaParenError luaBraceError luaError vimError vimKeyCodeError vimErrSetting vimBehaveError vimFTError vimFunctionError
	vimAugroupError vimFunc vimPatSepErr vimSubstFlagErr vimCollClassErr vimMapModErr vimSynCaseError vimHiCtermError vimHiAttribList vimHiKeyError
Todo	Todo vimTodo luaTodo
String	String NvimString NvimStringBody NvimStringQuote NvimSingleQuote NvimSingleQuotedBody NvimDoubleQuote NvimDoubleQuotedBody NvimInvalidStringBody
	NvimInvalidSingleQuotedBody NvimInvalidDoubleQuotedBody vimString vimLetHereDoc vimSearch vimSetString vimCommentString vimPatSepZone vimNotPatSep
	vimStringEnd vimStringCont vimSubstTwoBS vimSynRegPat vimSynPatRange vimInsert vimSynNotPatRange luaString2 luaString
Constant	Constant luaConstant
Character	Character
Number	Number Float NvimNumber NvimFloat vimNumber vimMark vimMarkNumber vimPlainMark vimAddress vimHiGuiRgb vimHiNmbr luaNumber
Boolean	Boolean
Function	Function vimFuncName luaFunction
Identifier	Identifier NvimIdentifier NvimIdentifierScope NvimIdentifierScopeDelimiter NvimIdentifierName NvimIdentifierKey NvimOptionName NvimOptionScope
	NvimOptionScopeDelimiter NvimEnvironmentName vimVar vimFBVar vimSpecFile vimFuncVar vimSpecFileMod luaFunc vimKeyCode
Statement	Statement Conditional Repeat Label Operator Exception NvimAssignment NvimPlainAssignment NvimAugmentedAssignment NvimAssignmentWithAddition
	NvimAssignmentWithSubtraction NvimAssignmentWithConcatenation NvimOperator NvimUnaryOperator NvimUnaryPlus NvimUnaryMinus NvimNot NvimBinaryOperator
	NvimComparison NvimComparisonModifier NvimBinaryPlus NvimBinaryMinus NvimConcat NvimConcatOrSubscript NvimOr NvimAnd NvimMultiplication NvimDivision
	NvimMod NvimTernary NvimTernaryColon vimCommand vimSubst vimAutoCmd vimLet vimMap vimSyntax vimBehave vimBehaveModel vimFTCmd vimNotFunc vimOper
	vimAugroupKey vimoperStar vimFuncKey vimAbb vimEchoHL vimHighlight vimNorm vimUnmap vimUserCommand vimSubst1 vimSetSep vimMapBang nvimMap nvimUnmap
	vimHiClear vimSearchDelim luaElse luaIn luaStatement luaCond luaRepeat luaLabel luaOperator luaFor vimAuHighlight vimAutoSet vimCondHL vimElseif
	vimKeyword vimStatement
Keyword	Keyword
PreProc	PreProc Include Define Macro PreCondit vimOption vimEnvvar vimUserAttrbKey vimSetMod vimMenuName vimMenuNameMore vimHiAttrib vimFgBgAttrib
	vimCommentTitle vimAutoCmdOpt vimHLMod
Type	Type StorageClass Structure Typedef NvimNumberPrefix NvimOptionSigil NvimEnvironmentSigil vimGroup vimHLGroup nvimHLGroup vimType vimPattern
	vimAutoEvent nvimAutoEvent vimEchoHLNone vimSynCase vimGroupName vimSynReg vimSyncC vimSyncGroupName vimSyncKey vimSyncGroup vimSyncNone vimHiGroup
	vimHiTerm vimHiCTerm vimHiStartStop vimHiCtermFgBg vimHiCtermul vimHiGui vimHiGuiFont vimHiGuiFgBg vimHiBlend luaTable vimSpecial vimUserAttrb
	vimUserAttrbCmplt vimSynType vimFTOption
Special	Special Tag SpecialChar Delimiter SpecialComment Debug NvimParenthesis NvimLambda NvimNestingParenthesis NvimCallingParenthesis NvimSubscript
	NvimSubscriptBracket NvimSubscriptColon NvimCurly NvimContainer NvimDict NvimList NvimColon NvimComma NvimArrow NvimRegister NvimStringSpecial
	NvimSingleQuotedQuote NvimDoubleQuotedEscape NvimInvalidStringSpecial NvimInvalidSingleQuotedQuote NvimInvalidDoubleQuotedEscape vimRegister
	vimCmplxRepeat vimNotation vimCtrlChar vimContinue vimParenSep vimSep vimFuncSID vimUserAttrbCmpltFunc vimPatSep vimPatSepZ vimPatSepR vimSubstSubstr
	vimSubstDelim vimSubstFlags vimPlainRegister vimLetHereDocStart vimLetHereDocStop vimAutoCmdMod vimMapModKey vimBracket vimMapMod vimMenuMod
	vimGroupSpecial vimIskSep luaSpecial vimSynOption vimSynContains vimSynKeyContainedin vimSynNextgroup vimGroupAdd vimGroupRem vimSynKeyOpt
	vimSynMtchOpt vimSynRegOpt vimSynMtchGrp
DiagnosticError	DiagnosticError DiagnosticVirtualTextError DiagnosticFloatingError DiagnosticSignError
DiagnosticWarn	DiagnosticWarn DiagnosticVirtualTextWarn DiagnosticFloatingWarn DiagnosticSignWarn
DiagnosticInfo	DiagnosticInfo DiagnosticVirtualTextInfo DiagnosticFloatingInfo DiagnosticSignInfo
DiagnosticHint	DiagnosticHint DiagnosticVirtualTextHint DiagnosticFloatingHint DiagnosticSignHint
DiagnosticUnderlineError	DiagnosticUnderlineError
DiagnosticUnderlineWarn	DiagnosticUnderlineWarn
DiagnosticUnderlineInfo	DiagnosticUnderlineInfo
DiagnosticUnderlineHint	DiagnosticUnderlineHint
MatchParen	MatchParen
Comment	Comment vimComment vim9Comment vimLineComment vimMtchComment vim9LineComment luaComment vimScriptDelim
Underlined	Underlined
Ignore	Ignore
NvimInternalError	NvimInternalError NvimFigureBrace NvimSingleQuotedUnknownEscape NvimInvalidSingleQuotedUnknownEscape
